==...........
==...........
==...........
==...........
==...........
==...........
==...........
==...........
==...........
==...........
==...........
==...........
==...........
==...........
==...........
==...........
==...........
==k..........
==...........
==...........
==...........
==...........
==...........
==...........
==g..........
==...........
==g..........
==...........
==g..........
==...........
==...........
==...........
==...........
==...........
==k..........
==...........
==k..........
==...........
==k..........
==...........
==...........
==...........
==...........
==...........
==k..........
==...........
==k..........
==...........
==...........
==]..........
==...........
==...........
==...........
==...........
==...........
==...$.......
==...$.......
==...$.......
==...........
==...........
==]]]...m....
==...........
==...........
==...........
==...........
==...........
==k..........
==...........
==...........
==...........
==g..........
==...........
==g..........
==...........
==g..........
==]].........
==...........
==...C...S...
==k..........
==]].........
.............
.............
==...........
==...........
==...........
==...........
==...........
==...........
==...........
==...........
==...........
==...........
==..K........
==...........
==...........
==...........
==...........
==...........
==...........
==...........
==...........
==...........
==...........
==...........
==...........
==...........
==...........
==...........
==...........
==...........
==...........
==k..........
==...........
==...........
==...........
==...........
==...........
==...........
==g..........
==...........
==g..........
==...........
==g..........
.............
.............
==...........
==]]....X....
==...........
.............
.............
==...........
==...........
==...........
==...........
==k..........
==...........
==...........
==...........
==...........
==...........
==k..........
==...........
==k..........
==...........
==k..........
==...........
==...........
==...........
==...........
==...........
==...........
==k..........
==...........
==k..........
==...........
==...........
==...........
==...........
==...........
==...........
==...........
==k..........
==...........
==k..........
==...........
==k..........
==...........
==...........
==......$....
==PPP<..$....
==PPP...$....
==......$....
==...........
==...........
==...........
==k..........
==...........
==...........
==...........
==g..........
==...........
==g..........
==...........
==g..........
==...........
==...........
==...........
==g..........
==............
==g..........
==...........
==g..........
==]..........
==]].........
==]]]........
==]]]].......
==]]]]]......
==]]]]]].....
==]]]]]]]....
==]]]]]]]]...
==]]]]]]]]...
==...........
==...........
==...........
==...........
==...........
==...........
==...........
==...........
==]F.........
==...........
==...........
==...........
==...........
==...........
==...........
==...........
==...........
==...........
==...........
==...........
==...........
==...........
==...........
==...........
==...........
==...........
==...........
==...........
==...........
==...........
==...........
==...........
==...........
