==...........
==...........
==...........
==...........
==...........
==...........
==...........
==...........
==...........
==...........
==...........
==...........
==...........
==...........
==...........
==...........
==...........
==...........
==...........
==>>.........
==...........
==...........
==...........
==...........
==...........
==...........
==.K.........
==.......M...
==>>>....X...
==.......X...
==...........
==...........
==...........
==...........
==...........
==...........
==>>.........
==...........
==...........
==...c.......
==...c.......
==...c.......
==...c.......
==...........
==..K........
==...........
==>>>........
==...........
==...........
==...........
==...........
==...........
==...........
==...........
==.K.........
==...........
==>>>........
==...........
==...........
==...........
==...........
==...........
==...X.......
==...X.......
==...]>>.....
==.K.C.......
==...X.......
==...........
==>>.........
==...........
==...........
==...........
==...........
.............
.............
==...........
==PPP<.......
==PPP........
==...........
==...........
==...........
==...........
==...X...X...
==...X...X...
==...X...X...
==...X@..X...
==...X...X...
==...X...X@..
==...X...X...
==...........
==...........
==...........
==...........
==PPq<.......
==PPq........
==...........
==...........
==...........
==...........
==...........
==...........
==...........
==...........
==...........
==>>.........
==...........
==...........
==...........
==...........
==PPP<.......
==PPP........
==...........
==...........
==...........
==...........
==PP<........
==PP.........
==...........
==...........
==...........
==...........
==...........
==>>.........
==...........
==...........
==...........
==...........
==...........
==PP<........
==PP.........
==...........
==...........
==...........
==...........
==...X...X...
==@..X...X...
==...X...X...
==...X@..X...
==...X...X...
==...........
==...........
==]]]........
==...........
==...........
==...........
==...........
==>>>........
==...........
==...........
==....X......
==....X......
==ZZ........M
.............
==].....X....
==]]....X....
==]]]........
==]]]].......
==]]]]]......
==]]]]]].....
==...........
==...........
==...........
==]..........
==]].........
==]]]........
==]]]].......
==]]]]]......
==]]]]]].....
==]]]]]]]....
==]]]]]]]]b..
==]]]]]]]]...
==...........
==...........
==...........
==...........
==...........
==...........
==...........
==...........
==]F.........
==...........
==...........
==...........
==...........
==...........
==...........
==...........
==...........
==...........
==...........
==...........
==...........
==...........
==...........
==...........
==...........
==...........
==...........
==...........
==...........
==...........
==...........
==...........
==...........
