==...........
==...........
==...........
==...........
==...........
==...........
==...........
==...........
==...........
==...........
==...........
==...........
==...........
==...........
==...........
.............
==.........&.
==]..........
==]]..K......
==]]]........
==]]]].......
.............
==]]]]]].....
==]]]]]]]....
==]]]]]]]]K..
==]]]]]]]]...
==...........
==...........
==...........
==...c.......
==...c.......
==...c.......
==...c.......
==...........
==...........
==...........
.............
==...........
==...........
==...........
==...........
==...........
==...........
==.......X...
==ZZ.....U...
.........X...
==.......X...
==.......X...
==.......X...
==.......X...
.........X...
==.......X...
.........X...
==.......X...
==.......X...
==.......X...
.........X...
==..K....X...
==.......X...
==.......X...
==.......X...
==.......X...
==.......X...
.........X...
==.......X...
==.......X...
==..K....X...
==.......X...
==.......X...
==..K....X...
==.......X...
==.......X...
==.......X...
==.......X...
==.......X...
==.......X...
==...........
==...X.......
.....X.......
.............
==...........
==...........
==...........
==...........
.............
==>>.........
==...........
==...........
==...........
==...........
==...........
==...........
==...K.......
==>>>........
==...........
==..K........
==...........
==...........
==...........
==...X.......
==...M.......
==...........
==...........
==...........
==...........
==>>.........
==...........
==...........
==...........
==...........
==...X.......
==b..X.......
==...........
==...........
==...........
==>..........
==...........
==...........
==...X.......
==...]>......
==...C.......
==b..........
==...........
==b..........
==...........
==>>>........
==...........
==...........
==...........
==...........
==...........
==PP<........
==PP.........
==...........
==...........
==...........
==...........
==...........
.............
==K..........
==...........
==...........
==PP<........
==PP.........
.............
==...........
.............
==...........
.............
.............
.............
.............
.............
.............
==...........
==...........
==PPPq<......
==PPPq.......
==...........
==...........
==...........
==...........
==...........
==PP<........
==PP.........
==...........
==...........
==...........
==...........
==...........
==..K........
==...........
==.K.........
==...........
.............
==>>...K.....
.............
.............
.............
==...........
==...........
==...........
==]..........
==]].........
==]]]g.......
==]]]].......
==]]]]]g.....
==...........
==...........
==b..........
==...........
==>>>........
==...........
==...........
==...........
==...........
==...........
==...........
==...........
==]..........
==]].........
==]]]........
.............
==]]]]]..K...
.............
.............
==]]]]]]]]...
==]]]]]]]]...
==...........
==...........
==...........
==...........
==...........
==...........
==...........
==...........
==]F.........
==...........
==...........
==...........
==...........
==...........
==...........
==...........
==...........
==...........
==...........
==...........
==...........
==...........
==...........
==...........
==...........
==...........
==...........
==...........
==...........
==...........
==...........
==...........
==...........
