++++++++..+++
++++++++..+++
++++++++..+++
+++++++...+++
++++++....+++
+++++.....+++
+++++.....+++
+++++.....+++
+++++.....+++
+++++.....+++
+++++.....+++
+++++.....+++
+++++.....+++
LLL.......+++
LLL.......+++
+++++.....+++
+++++.....+++
+++++.....+++
+++++.....+++
+++++.....+++
+++++.....+++
+++++.....+++
+++++.....+++
+++++...~++++
+++++.......+
+++++.......+
LL..........+
LL..........+
LL..........+
+++++.......+
++++~...m...+
+++++.......+
LL..........+
LL..........+
LL..........+
++++++......+
++++++......+
++++++..~++++
++++++...++++
++++++...++++
++++++...++++
++++++...++++
++++++...++++
++++++...++++
++++++...++++
++++++...++++
++++++...++++
++++++...++++
++++++...++++
++++++..~++++
++++++...++++
++++++...++++
++++++...++++
++++++...++++
++++++...++++
++++++...++++
++++++...++++
++++++...++++
++++++...++++
++++++...++++
++++++..~++++
++++++...++++
++++++...++++
++++++...++++
++++++...++++
++++++...++++
++++++...++++
++++++..~++++
++++++...++++
++++++...++++
++++++...++++
++++++...++++
+++++.......+
+++++.......+
+++++.......+
+++++.......+
+++++~......+
+++++.......+
+++++.......+
+++++.......+
+++++.....~++
+++++.......+
+++++.......+
+++++.......+
+++++~......+
+++++.......+
+++++.......+
+++++.......+
+++++.....~++
+++++.......+
+++++.......+
+++++.......+
+++++~......+
+++++.......+
+++++.......+
+++++.......+
+++++.......+
+++++.....+++
+++++.....+++
+++++.....+++
+++++.....+++
+++++.....+++
+++++.....+++
+++++.....+++
++..........+
++..........+
++...I......+
++.......I..+
++..........+
++...I......+
++.......I..+
++..........+
++...I......+
++.......I..+
++..........+
++..........+
+++++.......+
+++++.......+
+++++.......+
+++++.......+
++..........+
++..........+
++..........+
+++++.....+++
+++++.....+++
+++++.....+++
+++++.....+++
+++++.....+++
LL.._.......+
LL.._.......+
LL.._.......+
LL.._.......+
LL.._.......+
LL.._.......+
LL.._.......+
LL.._.......+
LL.._.......+
LL.._B......+
LL.._.......+
LL.._.......+
LL.._/......+
++++++t.....+
++++++...++++
++++++...++++
++..........+
++..........+
++..........+
++..........+
++..........+
++..........+
++..........+
++..........+
++..........+
++..........+
++..........+
++..........+
++..........+
++..........+
++..........+
++..........+
