++++++++..+++
++++++++..+++
++++++++..+++
+++++++...+++
++++++....+++
+++++.....+++
+++++.....+++
+++++.....+++
+++++.....+++
+++++.....+++
+++++.....+++
+++++.....+++
+++++.....+++
+++++.....+++
+++++.....+++
+++++.....+++
......}.....+
............+
+++++.......+
+++s+.......+
+++++.......+
............+
............+
+++++.......+
+++s+.......+
+++++.......+
............+
............+
+++++.......+
+++s+.......+
+++++.......+
......}.....+
............+
+++++.......+
+++++.......+
++........+++
++........+++
++........+++
++........+++
++........+++
++........+++
++........+++
++...c....+++
++...m....+++
++...c....+++
++........+++
LL..........+
LL..........+
++..........+
++..........+
++..........+
++..........+
++..........+
+++.......+++
+++s.....s+++
+++.......+++
++..........+
++..........+
++..........+
++..........+
++..........+
++..........+
++..........+
+++.......+++
+++s.....s+++
+++.......+++
++..........+
++..........+
++..........+
++..........+
++..........+
++..........+
++..........+
++..........+
++..........+
++..........+
++..........+
++..........+
++..........+
+++.......+++
+++s.....s+++
+++.....$.+++
++......$...+
++......$...+
++..........+
++..........+
++..........+
++..........+
LL.}........+
LL..........+
+++++.....+++
+++++.....+++
+++++.....+++
+++++.....+++
+++++.....+++
+++++.....+++
LL..........+
LL.}........+
LL..........+
+++++.......+
+++++.......+
+++++.......+
LL..........+
LL.}........+
LL..........+
+++++.......+
+++++.......+
+++++.......+
LL..........+
LL.}........+
LL..........+
+++++.....+++
+++++.....+++
+++++.....+++
+++++.....+++
+++++.....+++
++........+++
++........+++
+++++.....+++
+++++.....+++
+++++.....+++
+++++.....+++
+++++.....+++
+++++.....+++
+++++.....+++
+++++.....+++
+++++.....+++
+++++.....+++
LL.._.......+
LL.._.......+
LL.._.......+
LL.._.......+
LL.._....XXX+
LL.._....XXX+
LL.._.......+
LL.._.......+
LL.._.......+
LL.._B......+
LL.._.......+
LL.._.......+
LL.._/......+
++++++t.....+
++++++...++++
++++++...++++
++..........+
++..........+
++..........+
++..........+
++..........+
++..........+
++..........+
++..........+
++..........+
++..........+
++..........+
++..........+
++..........+
++..........+
++..........+
++..........+
