++++++++..+++
++++++++..+++
++++++++..+++
+++++++...+++
++++++....+++
+++++.....+++
+++++.......+
LL..........+
LL..........+
+++++.......+
+++++.......+
LL..........+
LL..........+
+++++.......+
+++++.......+
+++++.......+
++..........+
++..........+
++...++++...+
++...++++...+
++...++++...+
++...++++...+
++...++++...+
++...++++...+
++..........+
++...++++...+
++..........+
++...++++...+
++..........+
++...++++...+
++..........+
++...++++...+
++..........+
++...++++...+
++..........+
++...++++...+
++...++++...+
++...++++...+
++......+...+
++......+...+
++PPP<..+...+
++PPP...+...+
++......+...+
++......+...+
++...++++...+
++...++++...+
++...++++...+
++...++++...+
++...++++...+
++...++++...+
++...++++...+
++...++++...+
++...++++...+
++...+++s...+
++...++++...+
++...++++...+
++...++++...+
++...++++...+
++...++++...+
++...++++...+
++...s+++...+
++...++++...+
++...++++...+
++...++++...+
++...++++...+
++...++++...+
++...++++...+
++...++++...+
++...++++...+
++...++++...+
++...++++...+
++...++++...+
++...++++...+
++...++++...+
++...++++...+
++..........+
++..........+
+++++....++++
+++++....++++
+++++....++++
++..........+
++..........+
++..........+
++..........+
++..........+
++..........+
++..+.......+
++..+.......+
LL..........+
LL....+.....+
+++++.+.....+
LL..+.......+
LL..+.......+
LL..+..+....+
LL..+++.....+
++.....++...+
++..+...+...+
++..+...+...+
++..+.......+
++..+.......+
++..+...+...+
++..+...+...+
++..+...+...+
++..+...+...+
++..+.......+
++..+++++...+
++..+...+...+
++..+...+...+
++..+.......+
++..+.......+
++..+...+...+
++..+...+...+
++..+...+...+
++..+...+...+
++..+...+...+
++..+...s...+
++..+...+...+
++..+...+...+
++..+...+...+
++..+...+...+
++..+...+...+
++..+...+...+
++..s...+...+
++..+...+...+
++..+...+...+
++..+...+...+
++..+...+...+
++..+...+...+
++..+...+...+
++..+...+...+
++..+...+...+
++..+...+...+
++..+...+...+
++..+...+...+
++..+...+...+
++..+...+...+
++..+...+...+
++..+...+...+
++..+...+...+
++..+...+...+
++..+...+...+
++..+...+...+
++..+...+...+
++..+...+...+
++...+++++..+
++........+++
++........+++
++...........
++...........
++...........
++...........
++...........
+++++.......+
+++++.......+
+++++.......+
+++++.......+
++..........+
++..........+
+++++.......+
+++++.......+
LL.._.......+
LL.._.......+
LL..s.......+
LL.._.......+
LL}._.......+
LL.._.......+
LL.._.......+
LL.._.......+
LL.._.......+
LL.._B......+
LL.._.......+
LL.._.......+
LL.._/......+
++++++t.....+
++++++...++++
++++++...++++
++..........+
++..........+
++..........+
++..........+
++..........+
++..........+
++..........+
++..........+
++..........+
++..........+
++..........+
++..........+
++..........+
++..........+
++..........+
++..........+
