++++++++..+++
++++++++..+++
++++++++..+++
+++++++...+++
++++++....+++
+++++.....+++
+++++.....+++
+++++.....+++
+++++.....+++
+++++.....+++
+++++.....+++
+++++.....+++
+++++.....+++
+++++.....+++
+++++.....+++
+++++.....+++
LL..........+
LL..........+
LL.....)....+
LL..........+
LL....}.....+
LL..........+
LL....).....+
LL..........+
LL..........+
LL..........+
LL..........+
+++++.......+
+++++.....+++
+++++.....+++
+++++.....+++
+++++.....+++
++..........+
++..........+
++...+......+
++...+......+
++...++.....+
++...+++....+
++...++++...+
++...++++...+
++...++++...+
++...++++...+
++...++++...+
++...++++...+
++...++++...+
++...++++...+
++...++++...+
++...++++...+
++...++++...+
++...++++...+
++..........+
++..........+
++..........+
++..........+
++..+.......+
++..+...+...+
++..+...+...+
++..+...+...+
++..+...+...+
++..+...+...+
++..+...+...+
++..+...+...+
++..+...+...+
++..+...+...+
++..+...+...+
++..+...+...+
++..+.......+
++..........+
++..........+
++..........+
++...++++...+
++...++++...+
++...++++...+
++...++++...+
++...++++...+
++...++++...+
++...++++...+
++...++++...+
++...++++...+
++...++++...+
++...++++...+
++...++++...+
++...++++...+
++...++++...+
++...++++...+
++...++++...+
++...++++...+
++...++++...+
++....+++...+
++.....++...+
++......+...+
++......+...+
++..........+
+++++.......+
+++++.......+
+++++.......+
++..........+
++..........+
++..........+
++......+...+
LL......+...+
LL..........+
LL......+...+
++.....s+...+
LL......+...+
LL..........+
LL......+...+
++......+...+
++......+...+
++......+...+
++...++++...+
++...++++...+
++...++++...+
++...++++...+
++...++++...+
++...++++...+
++..........+
++..........+
++......+...+
++..+...+...+
++..+...+...+
++..+.......+
++..........+
++......+...+
++..+...+...+
++..+...+...+
++..+...+...+
++..+...+...+
++..+...+...+
++..+...+...+
++..+.......+
++..........+
++......+...+
++..+...+...+
++..+...+...+
++..+.......+
++..........+
++...++++...+
++......+...+
+++.....+...+
++++....+...+
+++++...+...+
+++++...+...+
+++++...+...+
+++++...+...+
+++++...+...+
+++++...+...+
+++++...+...+
+++++...+...+
+++++...+...+
+++++...+...+
+++++...+...+
+++++...+...+
+++++.......+
+++++.......+
+++++.......+
+++++.......+
+++++.......+
+++++.......+
+++++.......+
++..........+
++..........+
++..........+
+++++.......+
+++++.......+
+++++.......+
++..........+
++..........+
+++++.......+
+++++.......+
+++++.......+
+++++.......+
+++++.......+
+++++.......+
+++++.......+
+++++.......+
++..........+
++..........+
+++++.......+
+++++.......+
++..........+
++..........+
+++++.......+
+++++.......+
++..........+
++..........+
+++++.......+
+++++.......+
+++++.......+
+++++.......+
+++++.......+
+++++.......+
LL.._.......+
LL.._.......+
LL.._.......+
LL.._.......+
LL.._.......+
LL.._.......+
LL.._..}....+
LL.._.......+
LL.._.......+
LL.._B......+
LL.._.......+
LL.._.......+
LL.._/......+
++++++t.....+
++++++...++++
++++++...++++
++..........+
++..........+
++..........+
++..........+
++..........+
++..........+
++..........+
++..........+
++..........+
++..........+
++..........+
++..........+
++..........+
++..........+
++..........+
++..........+
