++++++++....+
++++++++....+
++++++++....+
+++++++.....+
++++++......+
+++++.......+
LL..........+
LL..........+
LL..........+
LL..........+
LL..........+
++..........+
++..........+
++..........+
++..........+
++..........+
++..........+
++..........+
++..........+
PPPP<.......+
PPPP........+
++..........+
++..........+
++..........+
++..........+
++..........+
++..........+
++..........+
++..........+
++..........+
++..........+
++..........+
++..........+
++..........+
++..........+
++..........+
++..........+
++..........+
++..........+
++..........+
++..........+
++..........+
++..........+
++..........+
++..........+
++..........+
++..........+
++..........+
++..........+
++..........+
++..........+
PPPq<.......+
PPPq........+
++..........+
++..........+
++..........+
++..........+
++..........+
++..........+
++..........+
++..........+
++..........+
+++++.......+
+++++.......+
+++++.......+
+++++.......+
LL..........+
LL..........+
LL..........+
LL..........+
LL..........+
LL..........+
LL..........+
LL..........+
LL..........+
+++++.......+
+++++...+...+
+++++...+...+
+++++...+...+
+++++...+...+
+++++.......+
PPPPPPq<....+
PPPPPPq.....+
+++++.......+
+++++.......+
+++++.......+
+++++.......+
+++++.......+
+++++.......+
+++++.......+
PPPPPPPP....+
PPPPPPPP....+
+++++.......+
+++++.......+
+++++.......+
+++++.......+
++..........+
++..........+
++..........+
++..........+
++..........+
++..........+
++..........+
++..........+
++..........+
++..........+
++..........+
++..........+
++..........+
++..........+
++..........+
++..........+
++..........+
++..........+
++..........+
PPPP<.......+
PPPP........+
++..........+
++..........+
++..........+
++..........+
++..........+
PPPPP<......+
PPPPP.......+
++..........+
++..........+
++..........+
++..........+
++..........+
++..........+
++..........+
++..........+
PPPq<.......+
PPPq........+
++..........+
++..........+
++..........+
++..........+
++..........+
++..........+
++..........+
++..........+
PPPPP<......+
PPPPP.......+
LL..........+
LL..........+
LL..........+
++..........+
++..........+
++..........+
++...I......+
++..........+
++...+PPq<..+
++...+PPq...+
++..........+
++..........+
++..........+
++..........+
++..........+
++..........+
++..........+
++..........+
++..........+
++..........+
++..........+
++..........+
++..........+
++..........+
++..........+
++..........+
++..........+
++..........+
++..........+
++..........+
++..........+
++..........+
++..........+
++..........+
++..........+
++..........+
++..........+
++..........+
++..........+
++..........+
++..........+
++..........+
++..........+
++..........+
++..........+
++..........+
++..........+
++..........+
++..........+
++..........+
++..........+
PPPP<.......+
PPPP........+
++..........+
+++++.......+
+++++.......+
+++++.......+
+++++.......+
+++++.......+
+++++.......+
PPPPPPP<....+
PPPPPPP.....+
+++++.......+
+++++.......+
+++++.......+
+++++.......+
+++++.......+
+++++.......+
PPPPPPPq<...+
PPPPPPPq....+
+++++.......+
+++++.......+
+++++.......+
+++++.......+
+++++.......+
+++++.......+
LL..........+
LL..........+
LL..........+
LL..........+
+++++.......+
+++++.......+
+++++.......+
+++++.......+
PPPPPPq<....+
PPPPPPq.....+
+++++.......+
+++++.......+
+++++.......+
+++++.......+
+++++.......+
+++++.......+
+++++.......+
+++++.......+
+++++.......+
+++++.......+
+++++.......+
+++++.......+
+++++.......+
+++++.......+
+++++.......+
+++++.......+
+++++.......+
+++++.......+
+++++.......+
+++++.......+
+++++.......+
+++++.......+
+++++.......+
+++++.......+
+++++.......+
+++++.......+
++..........+
++..........+
++..........+
PPPP<.......+
PPPP........+
++..........+
++..........+
++..........+
++..........+
++..........+
PPPq<.......+
PPPq........+
++..........+
++..........+
++..........+
++..........+
++..........+
++@.........+
++..........+
++..........+
++..........+
LL..........+
LL..........+
LL..}.......+
LL..........+
LL..........+
+++++.....+++
+++++.....+++
+++++.....+++
+++++.....+++
+++++.....+++
+++++.....+++
LL.._.......+
LL.._.......+
LL.._.......+
LL.._.......+
LL.._.......+
LL.._.......+
LL.._.......+
LL.._.......+
LL.._.......+
LL.._B......+
LL.._.......+
LL.._.......+
LL.._/......+
++++++t.....+
++++++...++++
++++++...++++
++..........+
++..........+
++..........+
++..........+
++..........+
++..........+
++..........+
++..........+
++..........+
++..........+
++..........+
++..........+
++..........+
++..........+
++..........+
++..........+
